6
200 200 20 20 255 0 0 255
400 200 2 0 20 25 0 160 255
200 300 40 20 255 22 182 255
250 250 20 50 255 2 543 255
20 200 23 120 2 122 3 255
400 400 90 90 122 122 3 255
0 0
20 20 30 30